
Características generales del producto:
Capacidad de lavado (Kg)	0,0 kg
Certificaciones de homologacion	CE
Color de panel de mandos	Blanco
Opcion Programa frio	
Volumen del tambor (l)	55 l
Control de espuma
Tipo de carga	Frontal
Nivel de ruido en el centrifugado en dB(A) re 1 pW	74 dB (A)
Velocidad máxima de centrifugado (rpm)	0 rpm
Opciones de regulacion de temperatura por separado	No
Peso neto (kg)	70,00 kg
Ojo de buey	Si
Progr de ensayo electrón SATO	
Distancia aparato-pared	59 cm
Progr Rop blanc/col tej resist	40°C, 60°C Eco, 60°C Prelavado, 90°C, frío
Progr Prend de tejidos delicad	40°C, 60°C, frío


Dimensiones:
Altura del producto	847 mm
Dimensiones del producto	847 x 600 x 590 mm
Alt para montaje bajo encimera	820,00 mm
Altura regulable en	1,50 cm
Fondo con puerta abierta (90°)	99,00 cm
Etiquetado energético
Clase de eficacia de lavado	A
Eficacia centrifugado	C


Datos técnicos:
Potencia de conexión (W)	2300 W
Intensidad corriente eléctrica (A)	10 A
Tensión (V)	220-240 V
Frecuencia (Hz)	50 Hz
Longitud del cable de alimentación eléctrica (cm)	160,0 cm
Tipo de clavija	Schuko con conexión a tierra
Prestaciones
Opciones de velocidades de centrifugado	Fijo
Saltar el centrifugado	Si
Indicador de avance del programa	por diodos LED
Indicador digital de cuenta atrás	No
Tiempo maximo de programcion diferida (h)	0 h
Prelavado	Disponible
Aclarado extra	No
Tipo de indic finaliz del prog por diodos LED


Precio: 273-430 €  dependiendo de donde lo compres.

El ruido y las vibraciones son minimas,y el consumo energetico genial,el precio es lo debeis mirar ya que depende de donde lo compres puedes ahorrarte casi 200€ por increible que parezca.
Es facil de limpiar tanto el tambor como el cajon del detergente,y el boton unico es una herramienta buena ya que no  complica la estetica ni tampoco nos complica a nosotros la vida.
